{
  "refrencePath": "refrence.json",
  "spriteSize": 64,
  "entryX": 2,
  "entryY": 2,
  "defaultTexture": 19,
  "defaultTextureCover":  6,
  "spriteSheet": "src_data/sprites/e.png",
  "map": [
    [ 6, 6, 6, 6, 6, 6, 6, 6, 6, 6, 6, 6, 6, 6, 6, 6, 6, 6, 6, 6, 6, 6, 6, 6, 6, 6, 6, 6, 6, 6, 6, 6, 6, 6, 6, 6, 6, 6, 6, 6, 6, 6, 6, 6, 6, 6, 6, 6, 6 ],
    [ 6, 19, 19, 19, 19, 6, 6, 6, 51, 52, 55, 6, 6, 19, 19, 19, 19, 6, 6, 19, 19, 19, 19, 6, 6, 19, 19, 19, 19, 6, 6, 19, 19, 19, 19, 6, 6, 19, 19, 19, 19, 6 ],
    [ 6, 50, 19, 19, 19, 6, 6, 6, 53, 54, 56, 6, 6, 19, 19, 19, 19, 6, 6, 19, 19, 19, 19, 6, 6, 19, 19, 19, 19, 6, 6, 19, 19, 19, 19, 6, 6, 19, 19, 19, 19, 6 ],
    [ 6, 19, 19, 19, 19, 19, 19, 19, 19, 19, 19, 6, 6, 19, 19, 19, 19, 6, 6, 19, 19, 19, 19, 6, 6, 19, 19, 19, 19, 6, 6, 19, 19, 19, 19, 6, 6, 19, 19, 19, 19, 6 ],
    [ 6, 19, 19, 19, 19, 6, 6, 19, 19, 19, 19, 6, 6, 19, 19, 19, 19, 6, 6, 19, 19, 19, 19, 6, 6, 19, 19, 19, 19, 6, 6, 19, 19, 19, 19, 6, 6, 19, 19, 19, 19, 6 ],
    [ 6, 19, 19, 19, 19, 6, 6, 19, 19, 19, 19, 6, 6, 19, 19, 19, 19, 6, 6, 19, 19, 19, 19, 6, 6, 19, 19, 19, 19, 6, 6, 19, 19, 19, 19, 6, 6, 19, 19, 19, 19, 6 ],
    [ 6, 19, 19, 19, 19, 6, 6, 19, 19, 19, 19, 6, 6, 19, 19, 19, 19, 6, 6, 19, 19, 19, 19, 6, 6, 19, 19, 19, 19, 6, 6, 19, 19, 19, 19, 6, 6, 19, 19, 19, 19, 6 ],
    [ 6, 19, 19, 19, 19, 6, 6, 19, 19, 19, 19, 6, 6, 19, 19, 19, 19, 6, 6, 19, 19, 19, 19, 6, 6, 19, 19, 19, 19, 6, 6, 19, 19, 19, 19, 6, 6, 19, 19, 19, 19, 6 ],
    [ 6, 19, 19, 19, 19, 6, 6, 19, 19, 19, 19, 6, 6, 19, 19, 19, 19, 6, 6, 19, 19, 19, 19, 6, 6, 19, 19, 19, 19, 6, 6, 19, 19, 19, 19, 6, 6, 19, 19, 19, 19, 6 ],
    [ 6, 19, 19, 19, 19, 6, 6, 19, 19, 19, 19, 6, 6, 19, 19, 19, 19, 6, 6, 19, 19, 19, 19, 6, 6, 19, 19, 19, 19, 6, 6, 19, 19, 19, 19, 6, 6, 19, 19, 19, 19, 6 ],
    [ 6, 19, 19, 19, 19, 6, 6, 19, 19, 19, 19, 6, 6, 19, 19, 19, 19, 6, 6, 19, 19, 19, 19, 6, 6, 19, 19, 19, 19, 6, 6, 19, 19, 19, 19, 6, 6, 19, 19, 19, 19, 6 ],
    [ 6, 19, 19, 19, 19, 6, 6, 19, 19, 19, 19, 6, 6, 19, 19, 19, 19, 6, 6, 19, 19, 19, 19, 6, 6, 19, 19, 19, 19, 6, 6, 19, 19, 19, 19, 6, 6, 19, 19, 19, 19, 6 ],
    [ 6, 19, 19, 19, 19, 6, 6, 19, 19, 19, 19, 6, 6, 19, 19, 19, 19, 6, 6, 19, 19, 19, 19, 6, 6, 19, 19, 19, 19, 6, 6, 19, 19, 19, 19, 6, 6, 19, 19, 19, 19, 6 ],
    [ 6, 19, 19, 19, 19, 19, 19, 19, 19, 19, 19, 6, 6, 19, 19, 19, 19, 6, 6, 19, 19, 19, 19, 6, 6, 19, 19, 19, 19, 6, 6, 19, 19, 19, 19, 6, 6, 19, 19, 19, 19, 6 ],
    [ 6, 19, 19, 19, 19, 19, 19, 19, 19, 19, 19, 6, 6, 19, 19, 19, 19, 6, 6, 19, 19, 19, 19, 6, 6, 19, 19, 19, 19, 6, 6, 19, 19, 19, 19, 6, 6, 19, 19, 19, 19, 6 ],
    [ 6, 6 , 6 , 6 , 6 , 6, 6, 19, 19, 19, 19, 6, 6, 19, 19, 19, 19, 6, 6, 19, 19, 19, 19, 6, 6, 19, 19, 19, 19, 6, 6, 19, 19, 19, 19, 6, 6, 19, 19, 19, 19, 6 ],
    [ 6, 6, 6, 6, 6, 6, 6, 19, 19, 19, 19, 6, 6, 19, 19, 19, 19, 6, 6, 19, 19, 19, 19, 6, 6, 19, 19, 19, 19, 6, 6, 19, 19, 19, 19, 6, 6, 19, 19, 19, 19, 6 ],
    [ 6, 6, 6, 6, 6, 6, 6, 19, 19, 19, 19, 6, 6, 19, 19, 19, 19, 6, 6, 19, 19, 19, 19, 6, 6, 19, 19, 19, 19, 6, 6, 19, 19, 19, 19, 6, 6, 19, 19, 19, 19, 6 ],
    [ 6, 6, 18, 6, 6, 6, 6, 19, 19, 19, 19, 6, 6, 19, 19, 19, 19, 6, 6, 19, 19, 19, 19, 6, 6, 19, 19, 19, 19, 6, 6, 19, 19, 19, 19, 6, 6, 19, 19, 19, 19, 6 ],
    [ 6, 6, 6, 6, 6, 6, 6, 19, 19, 19, 19, 6, 6, 19, 19, 19, 19, 6, 6, 19, 19, 19, 19, 6, 6, 19, 19, 19, 19, 6, 6, 19, 19, 19, 19, 6, 6, 19, 19, 19, 19, 6 ],
    [ 6, 19, 19, 19, 19, 6, 6, 19, 19, 19, 19, 6, 6, 19, 19, 19, 19, 6, 6, 19, 19, 19, 19, 6, 6, 19, 19, 19, 19, 6, 6, 19, 19, 19, 19, 6, 6, 19, 19, 19, 19, 6 ],
    [ 6, 19, 19, 19, 19, 6, 6, 19, 19, 19, 19, 6, 6, 19, 19, 19, 19, 6, 6, 19, 19, 19, 19, 6, 6, 19, 19, 19, 19, 6, 6, 19, 19, 19, 19, 6, 6, 19, 19, 19, 19, 6 ],
    [ 6, 19, 19, 19, 19, 6, 6, 19, 19, 19, 19, 6, 6, 19, 19, 19, 19, 6, 6, 19, 19, 19, 19, 6, 6, 19, 19, 19, 19, 6, 6, 19, 19, 19, 19, 6, 6, 19, 19, 19, 19, 6 ],
    [ 6, 19, 19, 19, 19, 6, 6, 19, 19, 19, 19, 6, 6, 19, 19, 19, 19, 6, 6, 19, 19, 19, 19, 6, 6, 19, 19, 19, 19, 6, 6, 19, 19, 19, 19, 6, 6, 19, 19, 19, 19, 6 ],
    [ 6, 19, 19, 19, 19, 6, 6, 19, 19, 19, 19, 6, 6, 19, 19, 19, 19, 6, 6, 19, 19, 19, 19, 6, 6, 19, 19, 19, 19, 6, 6, 19, 19, 19, 19, 6, 6, 19, 19, 19, 19, 6 ],
    [ 6, 19, 19, 19, 19, 6, 6, 19, 19, 19, 19, 6, 6, 19, 19, 19, 19, 6, 6, 19, 19, 19, 19, 6, 6, 19, 19, 19, 19, 6, 6, 19, 19, 19, 19, 6, 6, 19, 19, 19, 19, 6 ],
    [ 6, 19, 19, 19, 19, 6, 6, 19, 19, 19, 19, 6, 6, 19, 19, 19, 19, 6, 6, 19, 19, 19, 19, 6, 6, 19, 19, 19, 19, 6, 6, 19, 19, 19, 19, 6, 6, 19, 19, 19, 19, 6 ],
    [ 6, 19, 19, 19, 19, 6, 6, 19, 19, 19, 19, 6, 6, 19, 19, 19, 19, 6, 6, 19, 19, 19, 19, 6, 6, 19, 19, 19, 19, 6, 6, 19, 19, 19, 19, 6, 6, 19, 19, 19, 19, 6 ],
    [ 6, 19, 19, 19, 19, 6, 6, 19, 19, 19, 19, 6, 6, 19, 19, 19, 19, 6, 6, 19, 19, 19, 19, 6, 6, 19, 19, 19, 19, 6, 6, 19, 19, 19, 19, 6, 6, 19, 19, 19, 19, 6 ],
    [ 6, 19, 19, 19, 19, 6, 6, 19, 19, 19, 19, 6, 6, 19, 19, 19, 19, 6, 6, 19, 19, 19, 19, 6, 6, 19, 19, 19, 19, 6, 6, 19, 19, 19, 19, 6, 6, 19, 19, 19, 19, 6 ],
    [ 6, 19, 19, 19, 19, 6, 6, 19, 19, 19, 19, 6, 6, 19, 19, 19, 19, 6, 6, 19, 19, 19, 19, 6, 6, 19, 19, 19, 19, 6, 6, 19, 19, 19, 19, 6, 6, 19, 19, 19, 19, 6 ],
    [ 6, 19, 19, 19, 19, 6, 6, 19, 19, 19, 19, 6, 6, 19, 19, 19, 19, 6, 6, 19, 19, 19, 19, 6, 6, 19, 19, 19, 19, 6, 6, 19, 19, 19, 19, 6, 6, 19, 19, 19, 19, 6 ],
    [ 6, 19, 19, 19, 19, 6, 6, 19, 19, 19, 19, 6, 6, 19, 19, 19, 19, 6, 6, 19, 19, 19, 19, 6, 6, 19, 19, 19, 19, 6, 6, 19, 19, 19, 19, 6, 6, 19, 19, 19, 19, 6 ],
    [ 6, 19, 19, 19, 19, 6, 6, 19, 19, 19, 19, 6, 6, 19, 19, 19, 19, 6, 6, 19, 19, 19, 19, 6, 6, 19, 19, 19, 19, 6, 6, 19, 19, 19, 19, 6, 6, 19, 19, 19, 19, 6 ],
    [ 6, 19, 19, 19, 19, 6, 6, 19, 19, 19, 19, 6, 6, 19, 19, 19, 19, 6, 6, 19, 19, 19, 19, 6, 6, 19, 19, 19, 19, 6, 6, 19, 19, 19, 19, 6, 6, 19, 19, 19, 19, 6 ],
    [ 6, 19, 19, 19, 19, 6, 6, 19, 19, 19, 19, 6, 6, 19, 19, 19, 19, 6, 6, 19, 19, 19, 19, 6, 6, 19, 19, 19, 19, 6, 6, 19, 19, 19, 19, 6, 6, 19, 19, 19, 19, 6 ],
    [ 6, 19, 19, 19, 19, 6, 6, 19, 19, 19, 19, 6, 6, 19, 19, 19, 19, 6, 6, 19, 19, 19, 19, 6, 6, 19, 19, 19, 19, 6, 6, 19, 19, 19, 19, 6, 6, 19, 19, 19, 19, 6 ],
    [ 6, 19, 19, 19, 19, 6, 6, 19, 19, 19, 19, 6, 6, 19, 19, 19, 19, 6, 6, 19, 19, 19, 19, 6, 6, 19, 19, 19, 19, 6, 6, 19, 19, 19, 19, 6, 6, 19, 19, 19, 19, 6 ],
    [ 6, 19, 19, 19, 19, 6, 6, 19, 19, 19, 19, 6, 6, 19, 19, 19, 19, 6, 6, 19, 19, 19, 19, 6, 6, 19, 19, 19, 19, 6, 6, 19, 19, 19, 19, 6, 6, 19, 19, 19, 19, 6 ],
    [ 6, 19, 19, 19, 19, 6, 6, 19, 19, 19, 19, 6, 6, 19, 19, 19, 19, 6, 6, 19, 19, 19, 19, 6, 6, 19, 19, 19, 19, 6, 6, 19, 19, 19, 19, 6, 6, 19, 19, 19, 19, 6 ],
    [ 6, 19, 19, 19, 19, 6, 6, 19, 19, 19, 19, 6, 6, 19, 19, 19, 19, 6, 6, 19, 19, 19, 19, 6, 6, 19, 19, 19, 19, 6, 6, 19, 19, 19, 19, 6, 6, 19, 19, 19, 19, 6 ],
    [ 6, 19, 19, 19, 19, 6, 6, 19, 19, 19, 19, 6, 6, 19, 19, 19, 19, 6, 6, 19, 19, 19, 19, 6, 6, 19, 19, 19, 19, 6, 6, 19, 19, 19, 19, 6, 6, 19, 19, 19, 19, 6 ],
    [ 6, 19, 19, 19, 19, 6, 6, 19, 19, 19, 19, 6, 6, 19, 19, 19, 19, 6, 6, 19, 19, 19, 19, 6, 6, 19, 19, 19, 19, 6, 6, 19, 19, 19, 19, 6, 6, 19, 19, 19, 19, 6 ],
    [ 6, 19, 19, 19, 19, 6, 6, 19, 19, 19, 19, 6, 6, 19, 19, 19, 19, 6, 6, 19, 19, 19, 19, 6, 6, 19, 19, 19, 19, 6, 6, 19, 19, 19, 19, 6, 6, 19, 19, 19, 19, 6 ],
    [ 6, 19, 19, 19, 19, 6, 6, 19, 19, 19, 19, 6, 6, 19, 19, 19, 19, 6, 6, 19, 19, 19, 19, 6, 6, 19, 19, 19, 19, 6, 6, 19, 19, 19, 19, 6, 6, 19, 19, 19, 19, 6 ],
    [ 6, 19, 19, 19, 19, 6, 6, 19, 19, 19, 19, 6, 6, 19, 19, 19, 19, 6, 6, 19, 19, 19, 19, 6, 6, 19, 19, 19, 19, 6, 6, 19, 19, 19, 19, 6, 6, 19, 19, 19, 19, 6 ],
    [ 6, 19, 19, 19, 19, 6, 6, 19, 19, 19, 19, 6, 6, 19, 19, 19, 19, 6, 6, 19, 19, 19, 19, 6, 6, 19, 19, 19, 19, 6, 6, 19, 19, 19, 19, 6, 6, 19, 19, 19, 19, 6 ],
    [ 6, 19, 19, 19, 19, 6, 6, 19, 19, 19, 19, 6, 6, 19, 19, 19, 19, 6, 6, 19, 19, 19, 19, 6, 6, 19, 19, 19, 19, 6, 6, 19, 19, 19, 19, 6, 6, 19, 19, 19, 19, 6 ],
    [ 6, 19, 19, 19, 19, 6, 6, 19, 19, 19, 19, 6, 6, 19, 19, 19, 19, 6, 6, 19, 19, 19, 19, 6, 6, 19, 19, 19, 19, 6, 6, 19, 19, 19, 19, 6, 6, 19, 19, 19, 19, 6 ],
    [ 6, 19, 19, 19, 19, 19, 19, 19, 19, 19, 19, 6, 6, 19, 19, 19, 19, 6, 6, 19, 19, 19, 19, 6, 6, 19, 19, 19, 19, 6, 6, 19, 19, 19, 19, 6, 6, 19, 19, 19, 19, 6 ],
    [ 6, 19, 19, 19, 19, 19, 19, 19, 19, 19, 19, 6, 6, 19, 19, 19, 19, 6, 6, 19, 19, 19, 19, 6, 6, 19, 19, 19, 19, 6, 6, 19, 19, 19, 19, 6, 6, 19, 19, 19, 19, 6 ],
    [ 6, 6, 6, 6, 6, 6, 6, 6, 6, 6, 6, 6, 6, 6, 6, 6, 6, 6, 6, 6, 6, 6, 6, 6, 6, 6, 6, 6, 6, 6, 6, 6, 6, 6, 6, 6, 6, 6, 6, 6, 6, 6, 6, 6, 6, 6, 6, 6, 6 ]

  ],
  "eventCoordinates": [
    [ 1, 2, 1, 3 ]
  ],
  "enemies": [
    [ 1, 1, 0, 5 ],
    [ 1, 2, 0, 5 ],
    [ 1, 3, 0, 5 ],
    [ 1, 4, 0, 5 ],
    [ 1, 5, 0, 5 ],
    [ 1, 6, 0, 5 ],
    [ 1, 7, 0, 5 ],
    [ 1, 8, 0, 5 ],
    [ 1, 9, 0, 5 ],
    [ 1, 10, 0, 5 ],
    [ 1, 11, 0, 5 ],
    [ 1, 12, 0, 5 ],
    [ 1, 13, 0, 5 ],
    [ -10, -10, 0, 5 ]
  ]
}