{
  "refrencePath": "refrence2.json",
  "spriteSize": 64,
  "entryX": 0,
  "entryY": 0,
  "defaultTexture": 0,
  "defaultTextureCover": 0,
  "spriteSheet": "src_data/sprites/e.png",
  "map": [
    [ 0, 1, 0, 0, 0, 0 ],
    [ 0, 4, 2, 2, 2, 2, 2, 2, 2, 11, 11, 11, 2, 2, 2, 2, 2, 2, 3 ],
    [ 0, 7, 5, 5, 5, 5, 5, 5, 5, 5, 5, 5, 5, 5, 5, 5, 5, 5, 6 ],
    [ 0, 7, 5, 5, 5, 5, 5, 5, 5, 5, 5, 5, 5, 5, 5, 5, 5, 5, 6 ],
    [ 0, 7, 5, 5, 5, 5, 5, 5, 5, 5, 5, 5, 5, 5, 5, 5, 5, 5, 6 ],
    [ 0, 7, 5, 5, 5, 5, 5, 5, 5, 5, 5, 5, 5, 5, 5, 5, 5, 5, 6 ],
    [ 0, 7, 5, 5, 5, 5, 5, 5, 5, 5, 5, 5, 5, 5, 5, 5, 5, 5, 6 ],
    [ 0, 7, 5, 5, 5, 5, 5, 5, 5, 5, 5, 5, 5, 5, 5, 5, 5, 5, 6 ],
    [ 0, 7, 5, 5, 5, 5, 5, 5, 5, 5, 5, 5, 5, 5, 5, 5, 5, 5, 6 ],
    [ 0, 7, 5, 5, 5, 5, 5, 5, 5, 5, 5, 5, 5, 5, 5, 5, 5, 5, 6 ],
    [ 0, 7, 5, 5, 5, 5, 5, 5, 5, 5, 5, 5, 5, 5, 5, 5, 5, 5, 6 ],
    [ 0, 7, 5, 5, 5, 5, 5, 5, 5, 5, 5, 5, 5, 5, 5, 5, 5, 5, 6 ],
    [ 0, 7, 5, 5, 5, 5, 5, 5, 5, 5, 5, 5, 5, 5, 5, 5, 5, 5, 6 ],
    [ 0, 7, 5, 5, 5, 5, 5, 5, 5, 5, 5, 5, 5, 5, 5, 5, 5, 5, 6 ],
    [ 0, 7, 5, 5, 5, 5, 5, 5, 5, 5, 5, 5, 5, 5, 5, 5, 5, 5, 6 ],
    [ 0, 7, 5, 5, 5, 5, 5, 5, 5, 5, 5, 5, 5, 5, 5, 5, 5, 5, 6 ],
    [ 0, 7, 5, 5, 5, 5, 5, 5, 5, 5, 5, 5, 5, 5, 5, 5, 5, 5, 6 ],
    [ 0, 7, 5, 5, 5, 5, 5, 5, 5, 5, 5, 5, 5, 5, 5, 5, 5, 5, 6 ],
    [ 0, 7, 5, 5, 5, 5, 5, 5, 5, 5, 5, 5, 5, 5, 5, 5, 5, 5, 6 ],
    [ 0, 7, 5, 5, 5, 5, 5, 5, 5, 5, 5, 5, 5, 5, 5, 5, 5, 5, 6 ],
    [ 0, 7, 5, 5, 5, 5, 5, 5, 5, 5, 5, 5, 5, 5, 5, 5, 5, 5, 6 ],
    [ 0, 8, 9, 9, 9, 9, 9, 9, 9, 9, 9, 9, 9, 9, 9, 9, 9, 9, 10 ]



  ],
  "eventCoordinates": [
    [ 1, 0, 1, 4 ],
    [ 9, 0, 1, 1 ]
  ],
  "enemies": [
    [ 7, 7, 1, 20 ]
  ]
}