{
  "refrencePath": "refrence.json",
  "spriteSize": 64,
  "entryX": 2,
  "entryY": 2,
  "defaultTexture": 19,
  "defaultTextureCover":  6,
  "spriteSheet": "src_data/sprites/e.png",
  "map": [
    [ 6, 6, 6, 6, 6, 6, 6, 6, 6, 6, 6, 6, 6, 6, 6, 6, 6, 6, 6, 6, 6, 6, 6, 6, 6, 6, 6, 6, 6, 6, 6, 6, 6, 6, 6, 6, 6, 6, 6, 6, 6, 6, 6, 6, 6, 6, 6, 6, 6 ],
    [ 6, 19, 19, 19, 19, 6, 6, 6, 51, 52, 55, 6, 6, 19, 19, 19, 19, 6, 6, 19, 19, 19, 19, 6, 6, 19, 19, 19, 19, 6, 6, 19, 19, 19, 19, 6, 6, 19, 19, 19, 19, 6 ],
    [ 6, 19, 19, 19, 19, 6, 6, 6, 53, 54, 56, 6, 6, 19, 19, 19, 19, 6, 6, 19, 19, 19, 19, 6, 6, 19, 19, 19, 19, 6, 6, 19, 19, 19, 19, 6, 6, 19, 19, 19, 19, 6 ],
    [ 6, 19, 19, 19, 19, 6, 6, 19, 19, 19, 19, 6, 6, 19, 19, 19, 19, 6, 6, 19, 19, 19, 19, 6, 6, 19, 19, 19, 19, 6, 6, 19, 19, 19, 19, 6, 6, 19, 19, 19, 19, 6 ],
    [ 6, 19, 19, 19, 19, 6, 6, 19, 19, 19, 19, 6, 6, 19, 19, 19, 19, 6, 6, 19, 19, 19, 19, 6, 6, 19, 19, 19, 19, 6, 6, 19, 19, 19, 19, 6, 6, 19, 19, 19, 19, 6 ],
    [ 6, 19, 19, 19, 19, 6, 6, 19, 19, 19, 19, 6, 6, 19, 19, 19, 19, 6, 6, 19, 19, 19, 19, 6, 6, 19, 19, 19, 19, 6, 6, 19, 19, 19, 19, 6, 6, 19, 19, 19, 19, 6 ],
    [ 6, 19, 19, 19, 19, 6, 6, 19, 19, 19, 19, 6, 6, 19, 19, 19, 19, 6, 6, 19, 19, 19, 19, 6, 6, 19, 19, 19, 19, 6, 6, 19, 19, 19, 19, 6, 6, 19, 19, 19, 19, 6 ],
    [ 6, 19, 19, 19, 19, 6, 6, 19, 19, 19, 19, 6, 6, 19, 19, 19, 19, 6, 6, 19, 19, 19, 19, 6, 6, 19, 19, 19, 19, 6, 6, 19, 19, 19, 19, 6, 6, 19, 19, 19, 19, 6 ],
    [ 6, 19, 19, 19, 19, 6, 6, 19, 19, 19, 19, 6, 6, 19, 19, 19, 19, 6, 6, 19, 19, 19, 19, 6, 6, 19, 19, 19, 19, 6, 6, 19, 19, 19, 19, 6, 6, 19, 19, 19, 19, 6 ],
    [ 6, 19, 19, 19, 19, 6, 6, 19, 19, 19, 19, 6, 6, 19, 19, 19, 19, 6, 6, 19, 19, 19, 19, 6, 6, 19, 19, 19, 19, 6, 6, 19, 19, 19, 19, 6, 6, 19, 19, 19, 19, 6 ],
    [ 6, 19, 19, 19, 19, 6, 6, 19, 19, 19, 19, 6, 6, 19, 19, 19, 19, 6, 6, 19, 19, 19, 19, 6, 6, 19, 19, 19, 19, 6, 6, 19, 19, 19, 19, 6, 6, 19, 19, 19, 19, 6 ],
    [ 6, 19, 19, 19, 19, 6, 6, 19, 19, 19, 19, 6, 6, 19, 19, 19, 19, 6, 6, 19, 19, 19, 19, 6, 6, 19, 19, 19, 19, 6, 6, 19, 19, 19, 19, 6, 6, 19, 19, 19, 19, 6 ],
    [ 6, 19, 19, 19, 19, 6, 6, 19, 19, 19, 19, 6, 6, 19, 19, 19, 19, 6, 6, 19, 19, 19, 19, 6, 6, 19, 19, 19, 19, 6, 6, 19, 19, 19, 19, 6, 6, 19, 19, 19, 19, 6 ],
    [ 6, 19, 19, 19, 19, 19, 19, 19, 19, 19, 19, 6, 6, 19, 19, 19, 19, 6, 6, 19, 19, 19, 19, 6, 6, 19, 19, 19, 19, 6, 6, 19, 19, 19, 19, 6, 6, 19, 19, 19, 19, 6 ],
    [ 6, 19, 19, 19, 19, 19, 19, 19, 19, 19, 19, 6, 6, 19, 19, 19, 19, 6, 6, 19, 19, 19, 19, 6, 6, 19, 19, 19, 19, 6, 6, 19, 19, 19, 19, 6, 6, 19, 19, 19, 19, 6 ],
    [ 6, 6 , 6 , 6 , 6 , 6, 6, 19, 19, 19, 19, 6, 6, 19, 19, 19, 19, 6, 6, 19, 19, 19, 19, 6, 6, 19, 19, 19, 19, 6, 6, 19, 19, 19, 19, 6, 6, 19, 19, 19, 19, 6 ],
    [ 6, 6, 6, 6, 6, 6, 6, 19, 19, 19, 19, 6, 6, 19, 19, 19, 19, 6, 6, 19, 19, 19, 19, 6, 6, 19, 19, 19, 19, 6, 6, 19, 19, 19, 19, 6, 6, 19, 19, 19, 19, 6 ],
    [ 6, 6, 6, 6, 6, 6, 6, 19, 19, 19, 19, 6, 6, 19, 19, 19, 19, 6, 6, 19, 19, 19, 19, 6, 6, 19, 19, 19, 19, 6, 6, 19, 19, 19, 19, 6, 6, 19, 19, 19, 19, 6 ],
    [ 6, 6, 18, 6, 6, 6, 6, 19, 19, 19, 19, 6, 6, 19, 19, 19, 19, 6, 6, 19, 19, 19, 19, 6, 6, 19, 19, 19, 19, 6, 6, 19, 19, 19, 19, 6, 6, 19, 19, 19, 19, 6 ],
    [ 6, 6, 6, 6, 6, 6, 6, 19, 19, 19, 19, 6, 6, 19, 19, 19, 19, 6, 6, 19, 19, 19, 19, 6, 6, 19, 19, 19, 19, 6, 6, 19, 19, 19, 19, 6, 6, 19, 19, 19, 19, 6 ],
    [ 6, 19, 19, 19, 19, 6, 6, 19, 19, 19, 19, 6, 6, 19, 19, 19, 19, 6, 6, 19, 19, 19, 19, 6, 6, 19, 19, 19, 19, 6, 6, 19, 19, 19, 19, 6, 6, 19, 19, 19, 19, 6 ],
    [ 6, 19, 19, 19, 19, 6, 6, 19, 19, 19, 19, 6, 6, 19, 19, 19, 19, 6, 6, 19, 19, 19, 19, 6, 6, 19, 19, 19, 19, 6, 6, 19, 19, 19, 19, 6, 6, 19, 19, 19, 19, 6 ],
    [ 6, 19, 19, 19, 19, 6, 6, 19, 19, 19, 19, 6, 6, 19, 19, 19, 19, 6, 6, 19, 19, 19, 19, 6, 6, 19, 19, 19, 19, 6, 6, 19, 19, 19, 19, 6, 6, 19, 19, 19, 19, 6 ],
    [ 6, 19, 19, 19, 19, 6, 6, 19, 19, 19, 19, 6, 6, 19, 19, 19, 19, 6, 6, 19, 19, 19, 19, 6, 6, 19, 19, 19, 19, 6, 6, 19, 19, 19, 19, 6, 6, 19, 19, 19, 19, 6 ],
    [ 6, 19, 19, 19, 19, 6, 6, 19, 19, 19, 19, 6, 6, 19, 19, 19, 19, 6, 6, 19, 19, 19, 19, 6, 6, 19, 19, 19, 19, 6, 6, 19, 19, 19, 19, 6, 6, 19, 19, 19, 19, 6 ],
    [ 6, 19, 19, 19, 19, 6, 6, 19, 19, 19, 19, 6, 6, 19, 19, 19, 19, 6, 6, 19, 19, 19, 19, 6, 6, 19, 19, 19, 19, 6, 6, 19, 19, 19, 19, 6, 6, 19, 19, 19, 19, 6 ],
    [ 6, 19, 19, 19, 19, 6, 6, 19, 19, 19, 19, 6, 6, 19, 19, 19, 19, 6, 6, 19, 19, 19, 19, 6, 6, 19, 19, 19, 19, 6, 6, 19, 19, 19, 19, 6, 6, 19, 19, 19, 19, 6 ],
    [ 6, 19, 19, 19, 19, 6, 6, 19, 19, 19, 19, 6, 6, 19, 19, 19, 19, 6, 6, 19, 19, 19, 19, 6, 6, 19, 19, 19, 19, 6, 6, 19, 19, 19, 19, 6, 6, 19, 19, 19, 19, 6 ],
    [ 6, 19, 19, 19, 19, 6, 6, 19, 19, 19, 19, 6, 6, 19, 19, 19, 19, 6, 6, 19, 19, 19, 19, 6, 6, 19, 19, 19, 19, 6, 6, 19, 19, 19, 19, 6, 6, 19, 19, 19, 19, 6 ],
    [ 6, 19, 19, 19, 19, 6, 6, 19, 19, 19, 19, 6, 6, 19, 19, 19, 19, 6, 6, 19, 19, 19, 19, 6, 6, 19, 19, 19, 19, 6, 6, 19, 19, 19, 19, 6, 6, 19, 19, 19, 19, 6 ],
    [ 6, 19, 19, 19, 19, 6, 6, 19, 19, 19, 19, 6, 6, 19, 19, 19, 19, 6, 6, 19, 19, 19, 19, 6, 6, 19, 19, 19, 19, 6, 6, 19, 19, 19, 19, 6, 6, 19, 19, 19, 19, 6 ],
    [ 6, 19, 19, 19, 19, 6, 6, 19, 19, 19, 19, 6, 6, 19, 19, 19, 19, 6, 6, 19, 19, 19, 19, 6, 6, 19, 19, 19, 19, 6, 6, 19, 19, 19, 19, 6, 6, 19, 19, 19, 19, 6 ],
    [ 6, 19, 19, 19, 19, 6, 6, 19, 19, 19, 19, 6, 6, 19, 19, 19, 19, 6, 6, 19, 19, 19, 19, 6, 6, 19, 19, 19, 19, 6, 6, 19, 19, 19, 19, 6, 6, 19, 19, 19, 19, 6 ],
    [ 6, 19, 19, 19, 19, 6, 6, 19, 19, 19, 19, 6, 6, 19, 19, 19, 19, 6, 6, 19, 19, 19, 19, 6, 6, 19, 19, 19, 19, 6, 6, 19, 19, 19, 19, 6, 6, 19, 19, 19, 19, 6 ],
    [ 6, 19, 19, 19, 19, 6, 6, 19, 19, 19, 19, 6, 6, 19, 19, 19, 19, 6, 6, 19, 19, 19, 19, 6, 6, 19, 19, 19, 19, 6, 6, 19, 19, 19, 19, 6, 6, 19, 19, 19, 19, 6 ],
    [ 6, 19, 19, 19, 19, 6, 6, 19, 19, 19, 19, 6, 6, 19, 19, 19, 19, 6, 6, 19, 19, 19, 19, 6, 6, 19, 19, 19, 19, 6, 6, 19, 19, 19, 19, 6, 6, 19, 19, 19, 19, 6 ],
    [ 6, 19, 19, 19, 19, 6, 6, 19, 19, 19, 19, 6, 6, 19, 19, 19, 19, 6, 6, 19, 19, 19, 19, 6, 6, 19, 19, 19, 19, 6, 6, 19, 19, 19, 19, 6, 6, 19, 19, 19, 19, 6 ],
    [ 6, 19, 19, 19, 19, 6, 6, 19, 19, 19, 19, 6, 6, 19, 19, 19, 19, 6, 6, 19, 19, 19, 19, 6, 6, 19, 19, 19, 19, 6, 6, 19, 19, 19, 19, 6, 6, 19, 19, 19, 19, 6 ],
    [ 6, 19, 19, 19, 19, 6, 6, 19, 19, 19, 19, 6, 6, 19, 19, 19, 19, 6, 6, 19, 19, 19, 19, 6, 6, 19, 19, 19, 19, 6, 6, 19, 19, 19, 19, 6, 6, 19, 19, 19, 19, 6 ],
    [ 6, 19, 19, 19, 19, 6, 6, 19, 19, 19, 19, 6, 6, 19, 19, 19, 19, 6, 6, 19, 19, 19, 19, 6, 6, 19, 19, 19, 19, 6, 6, 19, 19, 19, 19, 6, 6, 19, 19, 19, 19, 6 ],
    [ 6, 19, 19, 19, 19, 6, 6, 19, 19, 19, 19, 6, 6, 19, 19, 19, 19, 6, 6, 19, 19, 19, 19, 6, 6, 19, 19, 19, 19, 6, 6, 19, 19, 19, 19, 6, 6, 19, 19, 19, 19, 6 ],
    [ 6, 19, 19, 19, 19, 6, 6, 19, 19, 19, 19, 6, 6, 19, 19, 19, 19, 6, 6, 19, 19, 19, 19, 6, 6, 19, 19, 19, 19, 6, 6, 19, 19, 19, 19, 6, 6, 19, 19, 19, 19, 6 ],
    [ 6, 19, 19, 19, 19, 6, 6, 19, 19, 19, 19, 6, 6, 19, 19, 19, 19, 6, 6, 19, 19, 19, 19, 6, 6, 19, 19, 19, 19, 6, 6, 19, 19, 19, 19, 6, 6, 19, 19, 19, 19, 6 ],
    [ 6, 19, 19, 19, 19, 6, 6, 19, 19, 19, 19, 6, 6, 19, 19, 19, 19, 6, 6, 19, 19, 19, 19, 6, 6, 19, 19, 19, 19, 6, 6, 19, 19, 19, 19, 6, 6, 19, 19, 19, 19, 6 ],
    [ 6, 19, 19, 19, 19, 6, 6, 19, 19, 19, 19, 6, 6, 19, 19, 19, 19, 6, 6, 19, 19, 19, 19, 6, 6, 19, 19, 19, 19, 6, 6, 19, 19, 19, 19, 6, 6, 19, 19, 19, 19, 6 ],
    [ 6, 19, 19, 19, 19, 6, 6, 19, 19, 19, 19, 6, 6, 19, 19, 19, 19, 6, 6, 19, 19, 19, 19, 6, 6, 19, 19, 19, 19, 6, 6, 19, 19, 19, 19, 6, 6, 19, 19, 19, 19, 6 ],
    [ 6, 19, 19, 19, 19, 6, 6, 19, 19, 19, 19, 6, 6, 19, 19, 19, 19, 6, 6, 19, 19, 19, 19, 6, 6, 19, 19, 19, 19, 6, 6, 19, 19, 19, 19, 6, 6, 19, 19, 19, 19, 6 ],
    [ 6, 19, 19, 19, 19, 6, 6, 19, 19, 19, 19, 6, 6, 19, 19, 19, 19, 6, 6, 19, 19, 19, 19, 6, 6, 19, 19, 19, 19, 6, 6, 19, 19, 19, 19, 6, 6, 19, 19, 19, 19, 6 ],
    [ 6, 19, 19, 19, 19, 6, 6, 19, 19, 19, 19, 6, 6, 19, 19, 19, 19, 6, 6, 19, 19, 19, 19, 6, 6, 19, 19, 19, 19, 6, 6, 19, 19, 19, 19, 6, 6, 19, 19, 19, 19, 6 ],
    [ 6, 19, 19, 19, 19, 6, 6, 19, 19, 19, 19, 6, 6, 19, 19, 19, 19, 6, 6, 19, 19, 19, 19, 6, 6, 19, 19, 19, 19, 6, 6, 19, 19, 19, 19, 6, 6, 19, 19, 19, 19, 6 ],
    [ 6, 19, 19, 19, 19, 6, 6, 19, 19, 19, 19, 6, 6, 19, 19, 19, 19, 6, 6, 19, 19, 19, 19, 6, 6, 19, 19, 19, 19, 6, 6, 19, 19, 19, 19, 6, 6, 19, 19, 19, 19, 6 ],
    [ 6, 6, 6, 6, 6, 6, 6, 6, 6, 6, 6, 6, 6, 6, 6, 6, 6, 6, 6, 6, 6, 6, 6, 6, 6, 6, 6, 6, 6, 6, 6, 6, 6, 6, 6, 6, 6, 6, 6, 6, 6, 6, 6, 6, 6, 6, 6, 6, 6 ]

  ],
  "eventCoordinates": [
    [ 1, 2, 1, 3 ]
  ],
  "enemies": [
    [ 1, 1, 0, 5]
  ]
}